#############
A     #     #
##### # ##### 
#     #     #
# ##### #####
#       #   B
#############
